[Status]
Empty=<img>stat:empty<img>
Keys=<img>stat:keys<img> × [keys:%02d]
SmCubes=<img>stat:smcubes<img> × [smcubes:%02d]
BgCubes=<img>stat:bgcubes<img> × [bgcubes:%01d]
RedAura=<img>stat:redaura<img>
BlueAura=<img>stat:blueaura<img>
SwimSuit=<img>stat:swimsuit<img>
ToxicSuit=<img>stat:toxicsuit<img>
Badge=<img>stat:badge<img>
Mask=<img>stat:mask<img>
Boots=<img>stat:boots<img>
Gloves=<img>stat:gloves<img>
MasterKey=<img>stat:mkey<img>
ArcPass=<img>stat:arcpass<img>
StyxPass=<img>stat:styxpass<img>
Necklace=<img>stat:necklace<img>

[Speedrun]
Retry=РЕСТАРТ ТРАССЫ
RetryConfirm=ЭТО ВЕРНЁТ ВАС К НАЧАЛУ ТРАССЫ И ВЫ ЛИШИТЕСЬ РЕЗУЛЬТА ТЕКУЩЕГО ЗАБЕГА. ВЫ УВЕРЕНЫ?
Exit=ПОКИНУТЬ ТРАССУ
ExitConfirm=ВЫ ПОКИНЕТЕ ТРАССУ И ЛИШИТЕСЬ РЕЗУЛЬТАТА ТЕКУЩЕГО ЗАБЕГА. ВЫ УВЕРЕНЫ?
Yes=ДА
No=НЕТ
Return=ВЕРНУТЬСЯ

[FullMap]
TotalGems=ВСЕГО    <img>stat:smcubes<img>: [smcubes_total:%03d] / [smcubes_max:%03d]
LocalGems=ЛОКАЛЬНО <img>stat:smcubes<img>: [smcubes_loc_coll:%02d] / [smcubes_loc_total:%02d]
LocalTitle=[loc_title]

[Collections]
DesertRuins=РУИНЫ В ПУСТЫНЕ
FireRealm=LAIR OF THE HOLLOW KING
IceCrossing=FROSTBITE PASS
IceWorld=GLACIAL PALACE
LakewoodDungeon=LAKEWOOD DUNGEON
Skyworld=SKY PILLARS
StyxCavesA=A HOLE IN THE WORLD
StyxCavesB=EVERY FLEETING MEMORY
StyxCavesC=WELCOME OBLIVION
StyxCavesD=NEVER FADES TO GRAY
StyxCavesE=THE LAST HURRAH
StyxCavesF=THIEVES' LANDING
StyxCavesG=UNCERTAINTY
Subcon=SUBCON
Subsubcon=HOUSE OF BAFFLE
Subterranea=SUBTERRANEAN WATERWAYS
ArcTower=ARCADIAN'S TOWER
AstTower=STARLIGHT TERRACE
CavesA=DEEP ELM PASS
CavesE=HIGHBORNE CAVERN
CavesG=ERROL'S ROAD
CavesK=CATACOMBS OF HOPE
CavesB=NORTHEAST NOOK
CavesD=MIDLAND NOOK
CavesI=FIRST ARC OF FIRE
CavesJ=SECOND ARC OF FIRE
CavesL=THE FOURTH CORNER
CavesC=ПЕЩЕРА ПОТЕРЯННЫХ КЛЮЧЕЙ
CavesH=GLACIAL SHELF
CavesF=SOUTHWEST NOOK
DesertSprawlA=ARCADIAN'S CACHE
DesertSprawlB=PINCER ISLAND
DesertSprawlC=JONAH'S PERCH
DesertTown=REVOLVER CROSSING
ForestA=STILLNESS
ForestB=MASHER WOODS
ForestC=SYLVAN PATH
GrassA=REVOLVER BRIDGE
GrassB=LAKEWOOD BRIDGE
GrassC=ЮЖНЫЙ МОСТ
GrassD=СЕВЕРНЫЙ МОСТ
SnowTown=FOUR CORNERS LODGE
SwampLake=BASIN RUNOFF
SwampTown=DEEP ELM BASIN
StyxTown=UNDERWORLD HOSTEL
Lakewood=TOWN OF LAKEWOOD
Stemmons=ОБЩИНА СТЕММОНА
FishingVillage=РЫБАЦКАЯ ДЕРЕВНЯ
IceCave=ЛАЧУГА ХИГГИНСА
SpeedrunOldArcadia=СТАРАЯ АРКАДИЯ
SpeedrunGallery=КОРОЛЕВСКАЯ ГАЛЛЕРЕЯ
SpeedrunBonehoard=THE BONEHOARD
SpeedrunDreamscape=DREAMSCAPE
SpeedrunLegacyCaves=ПЕЩЕРА НАСЛЕДИЯ
